1111111111111111111111111111111
100000001C000000000001000000001
1001111011111011111011101111111
10P000001000000G0010000100000E1
1011101110111011100010111111101
100010000C00000000101000C000001
1110111011101011111011101110111
100000C000000000C11G01000000011
1110111011101110111011101110111
1000100010000000001001000010001
1011101110111011111011101110111
100000000000C100001000000100001
1011111110111011101G10101111111
1000000C00000000000000000000001
1111111111111111111111111111111