11111111111111111
1P000000C00000001
10111110111011101
10000010001000001
10111011101110101
1C0000G0000G000E1
10111011101110101
10000010001000001
10111110111011101
1G000000C00000001
11111111111111111