1111111111111111111111111111111
1000000000000000000000000000001
1001111011111011111011101111001
10P00000100001000010000100000E1
1011101110111011101110111011101
1000100000000000000000000000101
1110111011111011111011101110111
100000000000000C000000000000001
1110111011101110111011101110111
1000100010000000000001000010001
1011101110111011111011101110111
1000000000000100001000000000001
1011111110111011101110111111111
100000000000000C000000000000001
1111111111111111111111111111111