111111
1E0001
101011
101011
1P0011
111111